########
#@'''''#
#''''''#
#''''''#
#''''''#
#''''''#
#''''''#
#''''''#
#''''''#
#''''''#
#''*''&#
########
