########
#@'''''#
#''**''#
#''++''#
#''++'*#
#''''**#
#'''**&#
########
